marine_environment	pollution
chemical_pollution	ocean
water_resources	natural_resources
eutrophication	ecosystem
freshwater	water
deforestation	ocean
marine_mammal	ocean
estuary	water
noise_level	environment
waste_disposal	environment
watercourse	water
atmospheric_conditions	ocean
freshwater	ecosystem
environmental_protection	ocean
soil_pollution	oil_pollution
environmental_standard	waste
marine_life	ocean
dust	drought
acidification	ocean
wastewater	water
environmental_policy	environment
plain	ecosystem
island	lake
wildlife	natural_resources
drought	environment
wolf	biodiversity
biotope	marine_ecosystem
bird	environment
whale	ocean
lake	ecosystem
reptile	desert
drinking_water	pollutant
natural_hazard	mountain
environmental_education	water
waste	ecosystem
groundwater	water
dolphin	ocean
national_park	water
mountain	flood
global_warming	environment
natural_resources	environmental_law
continental_shelf	ocean
climate	environmental_policy
corrosion	pollutant
ocean	environment
climate_change	ecosystem
pollution_control	environmental_protection
nuisance	environment
Elements Taxonomy:171.0261.0
Correct: 59
Precision: 0.34502923976608185
Recall: 0.2260536398467433
F1: 0.27314814814814814
